COMPANIES THAT RAISED $100M+ RECENTLY (NOW HIRING)

All 33 of these companies are actively hiring across the board:

1) Oxide Computer Company - new kind of server (Remote)
2) Defense Unicorns - airgap-native software delivery (US remote)
3) Baseten - AI inference platform (Bay Area / NYC / Remote)
4) Upwind Security - runtime cloud security (TLV / US / EMEA remote)
5) Decagon - AI customer support agents (Bay Area / NYC / London)
6) Upscale AI - open AI backend networks (Bay Area / India)
7) Parloa - AI agents for contact centers (Berlin / NYC / EU / US remote)
8) Zanskar - AI-native geothermal company (Salt Lake City)
9) Nelly Solutions - healthcare payments (Berlin / Munich)
10) Clear Street - clearing and prime brokerage (NYC / Chicago / London)
11) JetZero - blended wing body aircraft developer (LA)
12) WeLab - digital bank and fintech platform (Hong Kong)
13) Noveon Magnetics Inc. - rare earth manufacturer (Austin)
14) Highnote - unified payments platform for embedded finance (Bay Area)
15) Skild AI - robotic intelligence (Pittsburgh / Bay Area / Bengaluru)
16) Mytra - warehouse robotics and automation (Bay Area)
17) DayOne - data center development and operations (APAC / Europe)
18) Zarminali Pediatrics - pediatric care clinic (Central US)
19) ClickHouse - real-time analytics database (Global remote)
20) Mews - hotel property management (EU / US)
21) Waabi - autonomous trucking (Bay Area / remote North America)
22) Pennylane - accounting and finance software (France / Germany / EU)
23) Fluidstack - GPU cloud (Bay Area / Austin / NYC / US remote)
24) Varda Space Industries - space manufacturing (LA)
25) Torq - security automation platform (US / Tel Aviv / EU)
26) Oviva - digital nutrition and weight care (Switzerland / Poland / UK)
27) Neurophos - AI photonic chips (Austin / Bay Area)
28) Tulip Interfaces - frontline operations (Somerville / Budapest / Tel Aviv)
29) Arena - crowdsourced LLM evaluations (Bay Area)
30) Synthesia - AI video generation (London / NYC / EU)
31) Onebrief - planning software for military (DC / US / US remote)
32) Standard Nuclear - nuclear fuel (Oak Ridge)
33) Zipline - drone delivery logistics (Bay Area / Texas / Africa)